PLAYER_ID,RANK,PLAYER,TEAM,GAMES_PLAYED,MINUTES_PLAYED,TOTAL_THROWS_SCORED,TOTAL_THROWS_ATTEMPTS,THREE_THROWS_SCORED,THREE_THROWS_ATTEMPTS,FREE_THROWS_SCORED,FREE_THROWS_ATTEMPTS,OFFENSIVE_REBOUNDS,DEFFENSIVE_REBOUNDS,REB,ASSISTS,STEALS,BLOCKS,TOV,TOTAL_THROWS_MISSED,THREE_THROWS_MISSED,FREE_THROWS_MISSED,TOTAL_SCORE
201939,1,Stephen Curry,GSW,63,2152,658,1365,337,801,362,395,29,316,345,363,77,8,213,707,464,-33,107.99256505576209
203081,2,Damian Lillard,POR,67,2398,602,1334,275,704,449,484,32,251,283,505,62,17,203,732,429,-35,97.22685571309424
203999,3,Nikola Jokic,DEN,72,2488,732,1293,92,237,342,394,205,575,780,599,95,48,222,561,145,-52,151.225884244373
203078,4,Bradley Beal,WAS,60,2147,670,1382,130,373,408,459,72,211,283,265,69,22,187,712,243,-51,83.34885887284584
1629029,5,Luka Doncic,DAL,66,2262,647,1351,192,548,344,471,54,473,527,567,64,36,281,704,356,-127,128.55879752431477
203507,6,Giannis Antetokounmpo,MIL,61,2013,626,1100,67,221,398,581,97,574,671,357,72,73,207,474,154,-183,155.04222553402883
1626164,7,Devin Booker,PHX,67,2270,623,1287,126,371,340,392,34,247,281,289,53,16,207,664,245,-52,74.55947136563876
203944,7,Julius Randle,NYK,71,2667,602,1321,160,389,348,429,84,640,724,427,64,18,241,719,229,-81,111.67979002624674
1628369,9,Jayson Tatum,BOS,64,2290,605,1318,187,485,295,340,50,422,472,276,75,31,171,713,298,-45,92.96943231441048
1629627,10,Zion Williamson,NOP,61,2026,634,1037,10,34,369,529,167,274,441,226,57,39,167,403,24,-160,115.35044422507403
202696,11,Nikola Vucevic,CHI,70,2348,666,1396,176,440,131,156,146,671,817,269,65,48,126,730,264,-25,114.43781942078364
1629027,12,Trae Young,ATL,63,2125,487,1112,136,397,484,546,38,207,245,594,53,12,261,625,261,-62,107.55294117647058
203897,13,Zach LaVine,CHI,58,2034,569,1123,200,477,253,298,36,253,289,282,46,27,203,554,277,-45,90.04424778761062
1628368,14,De'Aaron Fox,SAC,58,2036,529,1110,103,320,300,417,33,170,203,417,87,27,174,581,217,-117,93.49214145383104
1629012,15,Collin Sexton,CLE,60,2115,525,1105,98,264,312,383,58,129,187,262,62,10,167,580,166,-71,69.83451536643027
203954,16,Joel Embiid,PHI,51,1585,461,899,58,154,471,548,113,426,539,145,50,69,159,438,96,-77,142.397476340694
202681,16,Kyrie Irving,BKN,54,1886,549,1086,152,378,201,218,52,205,257,324,76,37,130,537,226,-17,96.02332979851538
1627742,18,Brandon Ingram,NOP,61,2092,513,1101,143,375,281,320,34,265,299,296,42,36,154,588,232,-39,81.93116634799236
201566,19,Russell Westbrook,WAS,65,2369,544,1238,86,273,271,413,109,641,750,763,89,23,312,694,187,-142,151.09750949767835
1627759,20,Jaylen Brown,BOS,58,1999,538,1111,163,411,191,250,71,276,347,195,72,32,158,573,248,-59,84.8424212106053
1626179,21,Terry Rozier,CHA,69,2383,510,1134,222,571,165,202,47,255,302,293,87,26,128,624,349,-37,72.74443978178766
1628378,22,Donovan Mitchell,UTA,53,1771,478,1091,178,461,267,316,50,185,235,277,52,15,147,613,283,-49,84.7261434217956
1630162,23,Anthony Edwards,MIN,72,2314,505,1211,171,520,211,272,59,277,336,211,82,36,160,706,349,-61,63.63439930855661
203114,24,Khris Middleton,MIL,68,2269,511,1074,151,365,212,236,54,352,406,370,74,9,178,563,214,-24,92.90436315557514
203952,25,Andrew Wiggins,GSW,71,2364,505,1058,140,368,170,238,82,265,347,167,67,70,126,553,228,-68,69.24703891708968
201942,26,DeMar DeRozan,SAS,61,2056,455,920,19,74,387,440,40,219,259,422,56,15,119,465,55,-53,95.54961089494164
202695,27,Kawhi Leonard,LAC,52,1772,465,908,101,254,261,295,55,282,337,269,81,21,105,443,153,-34,106.51805869074491
1626181,28,Norman Powell,POR,69,2206,438,918,171,416,236,271,42,173,215,129,82,18,119,480,245,-35,60.94741613780599
1629628,29,RJ Barrett,NYK,72,2511,467,1060,124,309,206,276,68,346,414,217,53,20,139,593,185,-70,67.92114695340501
1627734,30,Domantas Sabonis,IND,62,2231,484,904,52,162,240,328,150,592,742,415,76,33,213,420,110,-88,134.06544150605112
202331,31,Paul George,LAC,54,1821,445,953,171,416,198,228,45,314,359,280,62,24,179,508,245,-30,100.08237232289952
203903,32,Jordan Clarkson,UTA,68,1818,457,1075,208,599,129,144,47,227,274,168,61,10,115,618,391,-15,60.91859185918592
1626157,33,Karl-Anthony Towns,MIN,50,1689,425,875,122,315,267,311,133,396,529,225,39,57,160,450,193,-44,124.42273534635879
202711,34,Bojan Bogdanovic,UTA,72,2216,406,925,180,461,233,265,40,241,281,136,45,4,128,519,281,-32,56.295126353790614
202699,35,Tobias Harris,PHI,62,2014,473,924,82,208,182,204,62,357,419,220,55,51,107,451,126,-22,90.76464746772592
203924,36,Jerami Grant,DET,54,1829,400,932,115,329,290,343,35,215,250,152,35,58,109,532,214,-53,68.89010388190268
1629630,37,Ja Morant,MEM,63,2053,430,957,73,241,271,372,59,193,252,465,57,13,203,527,168,-101,91.23234291281051
1628389,38,Bam Adebayo,MIA,64,2143,456,800,2,8,283,354,142,431,573,346,75,66,169,344,6,-71,124.03173121791879
1627783,39,Pascal Siakam,TOR,56,2006,437,961,73,246,249,301,95,310,405,250,64,37,130,524,173,-52,87.21335992023928
1627763,40,Malcolm Brogdon,IND,56,1930,444,980,145,374,153,177,58,236,294,329,49,15,115,536,229,-24,82.87564766839378
1627741,41,Buddy Hield,SAC,71,2433,403,992,282,721,88,104,29,305,334,257,63,30,130,589,439,-16,63.152486642005755
203501,42,Tim Hardaway Jr.,DAL,70,1985,407,911,207,529,142,174,20,209,229,126,31,11,64,504,322,-32,52.39294710327456
1629008,43,Michael Porter Jr.,DEN,61,1912,443,817,170,382,106,134,91,354,445,70,40,54,77,374,212,-28,86.4539748953975
1628415,44,Dillon Brooks,MEM,67,1997,432,1031,128,372,159,195,53,143,196,157,78,26,119,599,244,-36,51.97796695042564
101108,45,Chris Paul,PHX,70,2200,439,879,102,258,169,181,25,287,312,622,99,19,156,440,156,-12,111.5909090909091
2544,46,LeBron James,LAL,45,1504,422,823,104,285,178,255,29,317,346,350,48,25,168,401,181,-77,126.49601063829788
202710,47,Jimmy Butler,MIA,52,1745,366,736,25,102,359,416,94,265,359,369,108,18,109,370,77,-57,125.35816618911176
1628381,48,John Collins,ATL,63,1848,429,771,83,208,170,204,118,349,467,78,34,63,84,342,125,-34,90.39502164502164
203468,49,CJ McCollum,POR,47,1600,405,884,169,420,108,133,30,155,185,223,44,21,65,479,251,-25,73.71875
201935,50,James Harden,BKN,44,1609,342,734,121,334,278,323,35,313,348,475,53,33,177,392,213,-45,135.95400870105655
202685,51,Jonas Valanciunas,MEM,62,1755,440,743,21,57,157,203,253,523,776,112,35,57,100,303,36,-46,133.56125356125358
1627749,52,Dejounte Murray,SAS,67,2139,441,974,63,199,106,134,58,415,473,363,101,7,117,533,136,-28,94.24964936886396
201950,53,Jrue Holiday,MIL,59,1907,414,823,111,283,107,136,73,195,268,357,96,37,127,409,172,-29,95.85736759307814
1629632,54,Coby White,CHI,69,2156,375,902,163,454,128,142,28,256,284,328,38,15,156,527,291,-14,65.42207792207793
1627832,55,Fred VanVleet,TOR,52,1899,338,870,174,476,169,191,32,188,220,328,87,37,95,532,302,-22,78.83096366508688
1627750,56,Jamal Murray,DEN,48,1704,378,792,129,316,133,153,37,157,194,231,64,13,108,414,187,-20,75.79225352112677
203497,57,Rudy Gobert,UTA,71,2187,391,579,0,4,233,374,240,720,960,89,40,190,118,188,4,-141,144.90169181527207
1629028,58,Deandre Ayton,PHX,69,2115,430,687,4,20,133,173,228,499,727,99,41,81,103,257,16,-40,107.3758865248227
203925,59,Joe Harris,BKN,69,2142,357,707,211,444,49,63,43,205,248,130,46,14,62,350,233,-14,59.547152194211016
1628969,60,Mikal Bridges,PHX,72,2348,363,669,134,315,110,131,76,233,309,152,76,63,57,306,181,-21,67.90885860306643
203991,61,Clint Capela,ATL,63,1898,413,695,0,0,130,227,297,606,903,49,44,129,73,282,0,-97,139.72602739726028
1627747,62,Caris LeVert,IND,47,1485,359,814,84,258,146,180,33,181,214,245,66,30,102,455,174,-34,84.24242424242424
203482,63,Kelly Olynyk,HOU,70,1997,337,697,126,368,145,175,87,402,489,203,79,42,126,360,242,-30,93.74061091637456
201142,64,Kevin Durant,BKN,35,1157,324,603,85,189,210,238,13,234,247,195,25,45,120,279,104,-28,123.68193604148661
1629130,65,Duncan Robinson,MIA,72,2262,315,717,250,613,62,75,7,243,250,127,43,20,81,402,363,-13,49.358974358974365
1629636,66,Darius Garland,CLE,54,1790,362,802,105,266,112,132,23,106,129,329,66,6,164,440,161,-20,70.02793296089386
203471,66,Dennis Schroder,LAL,61,1956,332,760,71,212,206,243,30,181,211,351,70,13,163,428,141,-37,77.12167689161554
203084,68,Harrison Barnes,SAC,58,2102,319,642,100,256,195,235,64,321,385,201,43,11,93,323,156,-40,77.06945765937203
1626149,69,Montrezl Harrell,LAL,69,1580,375,603,0,10,181,256,158,270,428,73,46,49,74,228,10,-75,102.91139240506328
2546,70,Carmelo Anthony,POR,69,1690,327,777,133,325,137,154,32,182,214,104,46,38,61,450,192,-17,58.698224852071
203926,71,Doug McDermott,IND,66,1619,354,665,111,286,80,98,60,161,221,85,20,6,53,311,175,-18,55.311920938851145
1629018,72,Gary Trent Jr.,TOR,58,1802,320,785,165,429,83,106,27,125,152,80,56,10,43,465,264,-23,39.51165371809101
1629640,73,Keldon Johnson,SAS,69,1968,338,705,60,181,145,196,93,319,412,121,40,24,78,367,121,-51,71.11280487804879
1628398,74,Kyle Kuzma,LAL,68,1954,335,757,137,380,67,97,108,309,417,127,35,41,113,422,243,-30,68.14227226202661
202339,75,Eric Bledsoe,NOP,71,2112,307,730,121,355,134,195,29,215,244,268,55,24,114,423,234,-61,62.878787878787875
1626158,75,Richaun Holmes,SAC,61,1781,366,575,2,11,135,170,144,360,504,101,39,96,75,209,9,-35,103.22852330151599
204001,77,Kristaps Porzingis,DAL,43,1327,325,683,97,258,118,138,82,299,381,68,20,58,51,358,161,-20,92.57724189902035
202330,78,Gordon Hayward,CHA,44,1496,311,658,85,205,156,185,37,221,258,181,52,14,91,347,120,-29,85.96256684491979
1626174,79,Christian Wood,HOU,41,1326,329,640,77,206,125,198,76,319,395,71,34,48,80,311,129,-73,104.33634992458522
201572,80,Brook Lopez,MIL,70,1902,322,640,95,281,120,142,104,243,347,50,40,103,64,318,186,-22,66.8769716088328
1628973,81,Jalen Brunson,DAL,68,1697,328,627,81,200,120,151,27,204,231,239,35,1,80,299,119,-31,76.10489098408956
1630180,81,Saddiq Bey,DET,70,1909,279,691,175,460,124,147,43,275,318,95,52,14,60,412,285,-23,58.74803562074384
203937,83,Kyle Anderson,MEM,69,1887,308,658,94,261,144,184,52,344,396,250,84,57,86,350,167,-40,97.05882352941177
1626162,84,Kelly Oubre Jr.,GSW,55,1688,318,724,90,285,123,177,82,247,329,73,57,42,70,406,195,-54,66.67654028436019
1628970,85,Miles Bridges,CHA,66,1932,313,622,116,290,98,113,81,316,397,147,44,52,106,309,174,-15,79.08902691511386
1628983,86,Shai Gilgeous-Alexander,OKC,35,1180,287,565,71,170,185,229,19,147,166,207,27,23,106,278,99,-44,99.61864406779661
1627732,87,Ben Simmons,PHI,58,1877,325,583,3,10,176,287,93,324,417,401,93,35,173,258,7,-111,124.5338305807139
202689,87,Kemba Walker,OKC,43,1369,284,676,127,353,134,149,16,154,170,212,48,12,88,392,226,-15,74.14170927684441
1628367,89,Josh Jackson,DET,62,1560,296,707,77,257,159,218,57,197,254,143,53,47,142,411,180,-59,71.21794871794872
201144,90,Mike Conley,UTA,51,1498,284,640,138,335,121,142,36,141,177,305,70,9,99,356,197,-21,92.1562082777036
1629023,91,P.J. Washington,CHA,64,1954,302,686,112,290,108,145,93,325,418,161,69,79,128,384,178,-37,84.69805527123849
202322,92,John Wall,HOU,40,1288,293,726,79,249,158,211,17,112,129,275,42,31,141,433,170,-53,81.44409937888199
201152,92,Thaddeus Young,CHI,68,1652,370,662,12,45,71,113,168,255,423,291,74,40,137,292,33,-42,115.46610169491525
1628989,94,Kevin Huerter,ATL,69,2126,316,731,140,386,50,64,38,193,231,241,82,18,79,415,246,-14,58.419567262464724
1628449,95,Chris Boucher,TOR,60,1453,288,560,90,235,152,193,117,287,404,63,35,111,46,272,145,-41,104.78320715760496
1629003,96,Shake Milton,PHI,63,1461,300,667,71,203,146,176,33,115,148,193,39,18,103,367,132,-30,65.63997262149212
1628984,97,Devonte' Graham,CHA,55,1659,252,669,179,477,133,158,22,126,148,295,48,6,84,417,298,-25,67.8119349005425
1629134,97,Kendrick Nunn,MIA,56,1650,319,658,122,320,56,60,21,158,179,148,52,14,80,339,198,-4,57.3939393939394
1629639,99,Tyler Herro,MIA,54,1635,307,699,107,297,94,117,25,243,268,184,35,17,101,392,190,-23,67.95107033639144
204060,100,Joe Ingles,UTA,67,1867,275,562,183,406,76,90,27,217,244,318,45,12,117,287,223,-14,84.3867166577397
202683,101,Enes Kanter,POR,72,1757,339,561,1,4,127,164,284,511,795,84,33,48,78,222,3,-37,127.06317586795674
1628386,101,Jarrett Allen,CLE,63,1864,298,482,6,19,204,290,196,435,631,106,32,90,100,184,13,-86,115.47746781115879
1630163,103,LaMelo Ball,CHA,51,1469,293,672,92,261,125,165,63,239,302,313,81,18,145,379,169,-40,109.63240299523484
1628366,104,Lonzo Ball,NOP,55,1747,290,700,172,455,50,64,33,230,263,316,82,31,123,410,283,-14,85.94733829421865
1626156,105,D'Angelo Russell,MIN,42,1196,281,652,120,310,114,149,16,95,111,244,45,18,112,371,190,-35,84.86622073578596
1630256,106,Jae'Sean Tate,HOU,70,2043,316,625,60,195,102,147,132,242,374,178,85,36,98,309,135,-45,76.48066568771415
200768,107,Kyle Lowry,TOR,46,1602,260,596,131,331,140,160,35,212,247,338,45,14,126,336,200,-20,94.25717852684144
1629060,108,Rui Hachimura,WAS,57,1797,310,648,45,137,124,161,49,263,312,82,44,7,68,338,92,-37,59.20979410127991
1628407,109,Dwayne Bacon,ORL,72,1853,292,726,59,207,145,176,31,193,224,93,45,5,46,434,148,-31,41.44630329195898
203076,110,Anthony Davis,LAL,36,1162,301,613,26,100,158,214,62,224,286,110,45,59,74,312,74,-56,104.56110154905336
1629675,111,Naz Reid,MIN,70,1347,304,581,61,174,115,166,82,240,322,72,34,76,69,277,113,-51,92.68745360059391
202694,112,Marcus Morris Sr.,LAC,57,1502,276,584,140,296,73,89,35,199,234,58,34,15,57,308,156,-16,63.84820239680427
203200,113,Justin Holiday,IND,72,2183,258,625,173,453,67,85,32,224,256,119,74,41,54,367,280,-18,51.717819514429685
1626171,114,Bobby Portis,MIL,66,1372,313,598,74,157,54,73,124,342,466,71,52,26,56,285,83,-19,107.90816326530613
1629647,114,Darius Bazley,OKC,55,1714,273,690,83,286,125,178,51,345,396,99,29,25,122,417,203,-53,64.49824970828472
1630169,116,Tyrese Haliburton,SAC,58,1746,292,619,121,296,48,56,39,134,173,309,77,28,92,327,175,-8,78.6082474226804
201145,117,Jeff Green,BKN,68,1835,261,530,103,250,125,161,34,229,263,108,36,27,54,269,147,-36,62.425068119891
101150,118,Lou Williams,ATL,66,1423,265,646,69,173,150,173,21,117,138,225,47,6,108,381,104,-23,69.36050597329584
201988,119,Patty Mills,SAS,68,1685,252,611,161,429,71,78,18,98,116,162,42,3,66,359,268,-7,43.916913946587535
201565,120,Derrick Rose,NYK,50,1279,287,611,50,129,110,127,20,110,130,209,49,19,78,324,79,-17,76.97419859265051
1630193,121,Immanuel Quickley,NYK,64,1244,229,580,118,303,155,174,25,112,137,127,30,12,58,351,185,-19,61.937299035369776
1629652,122,Luguentz Dort,OKC,52,1543,247,639,113,329,122,164,38,151,189,88,45,19,79,392,216,-42,49.319507453013614
1627736,123,Malik Beasley,MIN,37,1214,264,600,128,321,68,80,28,134,162,88,30,7,60,336,193,-12,58.196046128500825
203992,124,Bogdan Bogdanovic,ATL,44,1305,267,565,146,333,40,44,20,140,160,147,49,13,54,298,187,-4,73.37164750957854
203095,125,Evan Fournier,BOS,42,1259,247,541,117,283,108,137,10,118,128,144,47,19,73,294,166,-29,72.67672756155679
203082,126,Terrence Ross,ORL,46,1347,254,616,89,264,120,138,15,143,158,108,47,21,74,362,175,-18,55.642167780252414
200752,127,Rudy Gay,SAS,63,1358,264,628,106,278,82,102,42,261,303,88,45,40,65,364,172,-20,77.98232695139912
1626196,128,Josh Richardson,DAL,59,1790,264,618,88,267,99,108,51,144,195,153,61,24,79,354,179,-9,52.541899441340775
202704,128,Reggie Jackson,LAC,67,1544,263,585,122,282,67,82,24,168,192,205,41,7,74,322,160,-15,69.94818652849742
203552,130,Seth Curry,PHI,57,1638,258,552,126,280,69,77,10,126,136,155,44,8,65,294,154,-8,56.043956043956044
203115,130,Will Barton,DEN,56,1736,259,608,98,257,95,121,39,187,226,181,50,23,96,349,159,-26,63.16244239631337
203493,132,Reggie Bullock,NYK,65,1949,248,561,163,398,50,55,16,207,223,99,52,11,45,313,235,-5,48.66598255515649
1627854,133,Bryn Forbes,MIL,70,1354,250,529,154,341,47,61,11,101,112,45,24,1,44,279,187,-14,44.42392909896603
1628374,134,Lauri Markkanen,CHI,51,1317,250,521,119,296,76,92,35,233,268,45,26,15,52,271,177,-16,68.07137433561124
1628978,135,Donte DiVincenzo,MIL,66,1815,253,603,131,346,51,71,81,299,380,203,72,15,91,350,215,-20,80.24793388429752
203083,136,Andre Drummond,LAL,46,1242,282,572,0,8,123,205,166,385,551,94,63,49,124,290,8,-82,141.86795491143317
1628384,137,OG Anunoby,TOR,43,1433,249,519,104,261,80,102,54,183,237,94,66,32,75,270,157,-22,75.47103977669225
201568,138,Danilo Gallinari,ATL,51,1222,206,475,103,254,161,174,17,194,211,76,30,10,43,269,151,-13,71.80851063829788
201609,139,Goran Dragic,MIA,50,1337,240,555,91,244,101,122,25,144,169,219,33,8,118,315,153,-21,73.41062079281974
1629022,140,Lonnie Walker IV,SAS,60,1522,256,609,100,282,57,70,14,141,155,101,29,15,65,353,182,-13,41.32720105124836
1630177,141,Theo Maledon,OKC,65,1778,226,614,105,313,101,135,25,186,211,227,56,11,141,388,208,-34,58.60517435320585
202722,142,Davis Bertans,WAS,57,1464,193,478,169,428,100,115,18,150,168,49,33,13,33,285,259,-15,47.84836065573771
1630172,142,Patrick Williams,CHI,71,1983,255,528,54,138,91,125,66,261,327,99,64,46,98,273,84,-34,64.49823499747856
201980,144,Danny Green,PHI,69,1934,224,544,175,432,31,40,55,205,260,118,92,56,67,320,257,-9,63.46949327817993
203484,145,Kentavious Caldwell-Pope,LAL,67,1902,218,506,120,293,97,112,27,152,179,127,62,26,66,288,173,-15,52.18191377497371
203506,146,Victor Oladipo,MIA,33,1080,235,576,78,239,104,138,12,148,160,151,46,14,83,341,161,-34,75.23148148148148
1627826,147,Ivica Zubac,LAC,72,1609,257,394,1,4,135,171,189,330,519,90,24,62,81,137,3,-36,105.87321317588565
1630171,148,Isaac Okoro,CLE,67,2173,235,559,62,214,114,157,68,138,206,128,62,24,86,324,152,-43,42.705936493327194
1626153,149,Delon Wright,SAC,63,1748,240,518,64,172,101,126,65,204,269,278,101,30,83,278,108,-25,90.10297482837528
201577,150,Robin Lopez,WAS,71,1354,269,425,5,18,99,137,141,131,272,55,15,44,75,156,13,-38,76.25553914327917
203901,151,Elfrid Payton,NYK,63,1484,269,622,28,98,73,107,64,152,216,203,47,9,103,353,70,-34,67.31805929919138
1628464,152,Daniel Theis,CHI,65,1601,252,466,49,152,74,110,93,263,356,108,41,57,66,214,103,-36,81.54278575890068
203935,152,Marcus Smart,BOS,48,1581,203,510,93,282,128,162,36,131,167,273,72,23,96,307,189,-34,75.61669829222012
1630217,154,Desmond Bane,MEM,68,1519,234,499,117,271,40,49,31,179,210,118,41,16,59,265,154,-9,62.47531270572745
202692,155,Alec Burks,NYK,49,1255,210,500,102,246,101,118,21,206,227,107,31,14,49,290,144,-17,73.06772908366533
203932,156,Aaron Gordon,DEN,50,1384,231,499,59,176,97,149,77,207,284,161,33,34,97,268,117,-52,84.57369942196532
1626224,157,Cedi Osman,CLE,59,1511,219,586,99,324,76,95,38,163,201,174,53,9,80,367,225,-19,55.16214427531436
1629673,158,Jordan Poole,GSW,51,988,205,474,97,276,105,119,15,77,92,99,26,9,51,269,179,-14,56.2246963562753
1629634,159,Brandon Clarke,MEM,59,1415,256,495,20,77,78,113,97,231,328,95,60,51,33,239,57,-35,87.10247349823321
1628963,160,Marvin Bagley III,SAC,43,1112,247,490,37,108,77,134,106,212,318,43,21,21,59,243,71,-57,87.18525179856115
1628976,161,Wendell Carter Jr.,ORL,54,1375,230,457,15,51,131,179,132,311,443,104,35,42,78,227,36,-48,105.89090909090908
1630175,162,Cole Anthony,ORL,47,1273,219,552,58,172,109,131,38,183,221,192,30,18,106,333,114,-22,76.35506677140613
1628977,163,Hamidou Diallo,DET,52,1226,224,470,28,82,128,200,59,213,272,101,41,24,76,246,54,-72,89.55954323001632
203109,164,Jae Crowder,PHX,60,1648,199,492,148,380,57,75,32,250,282,127,48,27,55,293,232,-18,66.32281553398059
204456,165,T.J. McConnell,IND,69,1796,274,490,15,48,33,48,55,201,256,456,128,23,135,216,33,-15,108.88084632516704
1627751,166,Jakob Poeltl,SAS,69,1845,265,430,0,0,63,124,219,328,547,134,47,123,83,165,0,-61,106.93766937669378
203496,166,Robert Covington,POR,70,2243,204,509,135,356,50,62,61,405,466,117,101,84,64,305,221,-12,74.52073116362014
1626167,168,Myles Turner,IND,47,1455,206,432,69,206,111,142,63,243,306,48,40,159,67,226,137,-31,87.2508591065292
1627827,169,Dorian Finney-Smith,DAL,60,1921,220,466,119,302,31,41,98,228,326,102,52,25,48,246,183,-10,60.35918792295679
1629659,170,Talen Horton-Tucker,LAL,65,1304,224,489,37,131,100,129,25,144,169,181,63,21,105,265,94,-29,75.84355828220859
201937,171,Ricky Rubio,MIN,68,1772,193,498,66,214,130,150,28,195,223,433,98,4,111,305,148,-20,91.87358916478556
203486,172,Mason Plumlee,DET,56,1499,234,381,0,7,113,169,145,374,519,202,43,50,105,147,7,-56,127.85190126751166
1628971,173,Bruce Brown,BKN,65,1451,235,423,17,59,86,117,111,238,349,104,58,28,54,188,42,-31,88.76636802205375
1629661,173,Cameron Johnson,PHX,60,1437,203,483,117,335,50,59,33,166,199,86,37,16,40,280,218,-9,50.0347947112039
1629013,175,Landry Shamet,BKN,61,1403,186,456,129,333,66,78,11,101,112,99,31,10,48,270,204,-12,43.47826086956522
1629004,176,Svi Mykhailiuk,OKC,66,1324,208,506,105,314,38,50,24,139,163,110,51,12,88,298,209,-12,51.699395770392755
203526,177,Raul Neto,WAS,64,1403,209,447,64,164,75,85,28,128,156,146,73,6,53,238,100,-10,66.50035637918745
1628401,178,Derrick White,SAS,36,1064,186,453,84,243,97,114,13,94,107,127,26,36,45,267,159,-17,62.45300751879699
201587,179,Nicolas Batum,LAC,67,1835,191,412,110,272,48,58,50,266,316,148,69,37,53,221,162,-10,72.15258855585832
1630191,180,Isaiah Stewart,DET,68,1455,226,409,21,63,64,92,159,294,453,59,39,86,67,183,42,-28,99.51890034364261
1629676,181,Isaiah Roby,OKC,61,1425,207,429,32,109,87,117,89,252,341,107,52,37,113,222,77,-30,84.80701754385966
1629056,181,Terence Davis,SAC,61,1074,195,456,98,267,45,55,20,134,154,83,44,14,63,261,169,-10,61.778398510242084
1628960,183,Grayson Allen,MEM,50,1260,173,414,107,274,79,91,19,141,160,108,46,8,48,241,167,-12,62.182539682539684
1629026,184,Kenrich Williams,OKC,66,1426,219,411,52,117,36,63,84,189,273,152,55,17,76,192,65,-27,83.97615708274895
1628379,185,Luke Kennard,LAC,63,1232,197,414,100,224,26,31,15,146,161,104,23,9,48,217,124,-5,60.22727272727273
202709,186,Cory Joseph,DET,63,1446,200,426,45,132,72,88,35,124,159,213,61,18,79,226,87,-16,71.19640387275243
1630202,187,Payton Pritchard,BOS,66,1268,184,418,102,248,40,45,33,125,158,120,37,9,53,234,146,-5,60.488958990536275
1629638,188,Nickeil Alexander-Walker,NOP,46,1007,192,458,76,219,48,66,13,131,144,102,47,22,69,266,143,-18,67.77557100297915
201933,189,Blake Griffin,BKN,46,1187,174,411,70,205,87,117,35,190,225,140,32,15,62,237,135,-30,77.29570345408592
1626166,189,Cameron Payne,PHX,60,1079,191,395,73,166,50,56,16,128,144,217,36,16,60,204,93,-6,91.241890639481
1629014,191,Anfernee Simons,POR,64,1104,168,401,120,282,46,57,14,126,140,89,18,8,43,233,162,-11,57.699275362318836
200794,191,Paul Millsap,DEN,56,1162,191,401,49,143,71,98,76,186,262,98,51,36,51,210,94,-27,88.64027538726333
1627788,193,Furkan Korkmaz,PHI,55,1062,170,424,101,269,60,82,17,96,113,82,49,9,46,254,168,-22,56.873822975517896
1627777,194,Georges Niang,UTA,72,1154,177,405,124,292,22,23,28,148,176,59,25,8,51,228,168,-1,56.58578856152513
1626220,195,Royce O'Neale,UTA,71,2240,175,394,107,278,39,46,88,397,485,181,57,32,83,219,171,-7,72.92410714285714
1628370,196,Malik Monk,CHA,42,878,173,399,85,212,59,72,14,87,101,87,19,4,55,226,127,-13,59.73804100227791
1630178,197,Tyrese Maxey,PHI,61,936,198,429,31,103,61,70,11,93,104,120,26,13,41,231,72,-9,61.32478632478633
2730,198,Dwight Howard,PHI,69,1196,178,303,5,20,121,210,190,390,580,61,30,62,112,125,15,-89,146.4464882943144
203920,198,Khem Birch,TOR,67,1529,189,380,13,52,91,129,174,213,387,89,48,50,44,191,39,-38,85.25179856115108
201569,200,Eric Gordon,HOU,27,789,159,367,69,210,94,114,8,50,58,71,14,13,51,208,141,-20,48.98605830164765
203145,200,Kent Bazemore,GSW,67,1334,176,392,75,184,54,78,26,203,229,108,69,33,82,216,109,-24,78.44827586206897
1628420,200,Monte Morris,DEN,47,1196,186,387,51,134,58,73,11,85,96,150,34,13,34,201,83,-15,59.07190635451505
1628988,203,Aaron Holiday,IND,66,1176,170,436,67,182,68,83,15,74,89,123,46,13,66,266,115,-15,51.31802721088435
1629001,204,De'Anthony Melton,MEM,52,1045,172,393,87,211,41,51,30,131,161,132,60,31,66,221,124,-10,86.60287081339713
1629611,204,Terance Mann,LAC,67,1263,178,350,38,91,78,94,56,186,242,104,29,13,40,172,53,-16,74.38638163103721
203210,206,JaMychal Green,DEN,58,1120,173,374,79,198,46,57,85,192,277,53,26,22,53,201,119,-11,77.63392857142857
1626192,207,Pat Connaughton,MIL,69,1575,168,387,101,272,31,40,63,269,332,81,49,23,33,219,171,-9,66.95238095238095
201586,208,Serge Ibaka,LAC,41,955,186,365,39,115,43,53,73,202,275,74,9,47,44,179,76,-10,92.35602094240838
203469,209,Cody Zeller,CHA,48,1005,181,324,4,28,85,119,119,209,328,86,27,17,51,143,24,-34,107.06467661691543
1629637,210,Jaxson Hayes,NOP,60,964,175,280,6,14,93,120,92,165,257,35,25,38,39,105,8,-27,96.57676348547717
1630164,211,James Wiseman,GSW,39,836,191,368,12,38,54,86,55,171,226,26,11,36,60,177,26,-32,84.44976076555024
203107,212,Tomas Satoransky,CHI,58,1307,169,329,42,118,67,79,30,112,142,271,40,14,96,160,76,-12,82.17291507268554
203110,213,Draymond Green,GSW,63,1982,170,380,34,126,70,88,55,393,448,558,105,52,188,210,92,-18,123.25933400605449
1626145,214,Tyus Jones,MEM,70,1223,178,413,45,140,41,45,21,119,140,259,64,6,48,235,95,-4,80.335241210139
201961,214,Wayne Ellington,DET,46,1012,149,338,116,275,28,35,12,73,85,67,18,9,33,189,159,-7,47.480237154150196
201571,216,D.J. Augustin,HOU,57,1129,135,343,83,217,85,94,20,74,94,188,28,1,65,208,134,-9,63.684676705048716
203500,216,Steven Adams,NOP,58,1605,189,308,0,3,60,135,213,301,514,111,54,38,78,119,3,-75,105.20249221183802
203967,218,Dario Saric,PHX,50,871,153,342,47,135,84,99,46,144,190,65,30,4,57,189,88,-15,78.0711825487945
1628404,219,Josh Hart,NOP,47,1350,151,344,63,193,69,89,53,324,377,109,38,12,49,193,130,-20,85.25925925925925
1629645,220,Kevin Porter Jr.,HOU,26,836,156,367,50,161,69,94,20,79,99,164,19,8,91,211,111,-25,74.3421052631579
1630183,221,Jaden McDaniels,MIN,63,1511,164,367,72,198,27,45,52,180,232,71,35,60,47,203,126,-18,57.180675049636
201599,222,DeAndre Jordan,BKN,57,1246,190,249,0,1,46,92,117,310,427,93,17,65,85,59,1,-46,115.77046548956662
203994,223,Jusuf Nurkic,POR,37,880,171,333,12,30,70,113,86,246,332,125,38,39,73,162,18,-43,140.5681818181818
203458,224,Alex Len,WAS,64,979,171,278,8,25,73,116,78,182,260,49,20,64,55,107,17,-43,100.56179775280899
202066,224,Garrett Temple,CHI,56,1528,158,381,67,200,40,50,29,131,160,124,43,30,58,223,133,-10,48.65837696335078
1630231,226,Kenyon Martin Jr.,HOU,45,1068,162,318,35,96,60,84,73,169,242,48,30,41,38,156,61,-24,80.10299625468164
1629057,227,Robert Williams III,BOS,52,985,186,258,0,2,45,73,133,225,358,94,43,91,52,72,2,-28,142.03045685279187
1628425,228,Sterling Brown,HOU,51,1229,150,335,91,215,25,31,38,186,224,72,38,12,41,185,124,-6,66.15134255492269
203504,229,Trey Burke,DAL,62,911,151,353,58,164,51,57,10,44,54,81,36,7,33,202,106,-6,45.334796926454445
202684,230,Tristan Thompson,BOS,54,1287,169,326,0,3,71,120,169,270,439,67,24,33,62,157,3,-49,99.26184926184926
202693,231,Markieff Morris,LAL,61,1200,153,378,65,209,36,50,48,218,266,73,22,19,54,225,144,-14,61.583333333333336
203463,232,Ben McLemore,LAL,53,905,135,365,97,280,39,53,15,85,100,39,23,9,42,230,183,-14,37.51381215469613
1627756,232,Denzel Valentine,CHI,62,1036,155,416,80,242,16,17,24,173,197,105,30,7,42,261,162,-1,59.45945945945946
1628410,234,Edmond Sumner,IND,53,861,148,282,35,88,68,83,18,76,94,49,33,10,51,134,53,-15,61.26596980255516
201143,235,Al Horford,BOS,28,782,162,360,56,152,18,22,29,159,188,94,25,26,29,198,96,-4,89.64194373401536
1627884,236,Derrick Jones Jr.,POR,58,1318,147,304,43,136,59,91,77,128,205,47,37,54,32,157,93,-32,60.20485584218513
1630267,236,Facundo Campazzo,DEN,65,1425,120,315,76,216,80,91,22,112,134,232,79,14,73,195,140,-11,72.35087719298245
1628402,238,Frank Jackson,DET,40,738,134,293,61,150,61,75,15,71,86,36,15,1,34,159,89,-14,52.913279132791324
1630214,238,Xavier Tillman,MEM,59,1085,167,299,22,65,34,53,74,182,256,75,44,33,45,132,43,-19,87.51152073732719
1627752,240,Taurean Prince,CLE,41,905,131,327,62,155,65,76,19,123,142,76,28,23,47,196,93,-11,68.89502762430939
203914,241,Gary Harris,ORL,39,1080,138,345,48,141,64,78,21,58,79,78,28,11,37,207,93,-14,40.13888888888889
1628408,242,PJ Dozier,DEN,50,1088,148,355,47,149,42,66,35,147,182,92,31,22,46,207,102,-24,62.5
1629672,243,Eric Paschall,GSW,40,695,148,298,18,54,67,94,28,100,128,51,12,7,43,150,36,-27,71.94244604316546
1629655,244,Daniel Gafford,WAS,54,791,154,225,0,0,72,108,94,137,231,29,26,75,41,71,0,-36,118.71049304677624
1629669,245,Jaylen Nowell,MIN,42,759,142,335,50,150,45,55,19,76,95,62,22,12,28,193,100,-10,53.75494071146245
1629731,246,Dean Wade,CLE,63,1212,134,311,78,213,30,39,38,177,215,74,35,21,30,177,135,-9,62.08745874587459
1627823,247,Juancho Hernangomez,MIN,52,900,130,299,55,168,60,97,45,160,205,35,19,7,27,169,113,-37,67.16666666666666
1627814,248,Damion Lee,GSW,57,1079,128,274,77,194,40,44,22,158,180,73,38,8,30,146,117,-4,66.4967562557924
201952,249,Jeff Teague,MIL,55,950,123,284,36,82,89,105,15,73,88,132,34,12,64,161,46,-16,70.73684210526315
1627936,250,Alex Caruso,LAL,58,1216,133,305,55,137,49,76,31,139,170,160,64,15,76,172,82,-27,79.0296052631579
1629650,250,Moses Brown,BOS,43,920,146,268,0,0,78,126,154,229,383,10,31,47,43,122,0,-48,122.06521739130434
1627789,250,Timothe Luwawu-Cabarrot,BKN,58,1050,130,356,75,239,35,43,28,101,129,69,33,6,43,226,164,-8,41.23809523809524
202324,253,Derrick Favors,UTA,68,1039,155,243,0,2,59,80,138,238,376,44,32,68,36,88,2,-21,117.03561116458133
201949,254,James Johnson,NOP,51,1043,146,327,31,120,45,76,32,145,177,98,42,42,55,181,89,-31,72.91466922339406
1630197,255,Aleksej Pokusevski,OKC,45,1090,139,408,58,207,31,42,30,182,212,97,20,42,99,269,149,-11,57.29357798165138
1628964,255,Mo Bamba,ORL,46,725,142,301,38,118,45,66,76,189,265,35,14,58,36,159,80,-21,110.48275862068965
202326,257,DeMarcus Cousins,LAC,41,713,130,305,47,135,59,81,53,210,263,76,34,24,64,175,88,-22,122.44039270687237
1626195,258,Willy Hernangomez,NOP,47,846,151,268,1,10,62,93,117,217,334,50,22,23,34,117,9,-31,117.78959810874706
203087,259,Jeremy Lamb,IND,36,765,120,276,52,128,71,75,25,106,131,53,34,23,22,156,76,-4,78.03921568627452
1629726,260,Garrison Mathews,WAS,64,1038,97,237,76,198,84,95,16,71,87,26,29,7,10,140,122,-11,40.847784200385355
1630181,260,R.J. Hampton,ORL,51,888,136,313,27,87,55,82,29,150,179,87,21,10,53,177,60,-27,72.86036036036036
1630201,262,Malachi Flynn,TOR,47,928,127,340,54,168,45,56,10,106,116,137,38,7,43,213,114,-11,64.11637931034483
1628467,262,Maxi Kleber,DAL,50,1341,116,275,87,212,34,37,47,213,260,68,24,35,30,159,125,-3,64.5413870246085
1629660,262,Ty Jerome,OKC,33,788,128,287,71,168,26,34,10,81,91,120,20,6,47,159,97,-8,71.63705583756345
200746,265,LaMarcus Aldridge,BKN,26,674,140,296,31,80,41,47,19,99,118,49,11,29,27,156,49,-6,70.54896142433235
1629643,266,Chuma Okeke,ORL,45,1133,135,324,49,141,30,40,42,139,181,101,48,22,38,189,92,-10,65.93115622241837
1629667,267,Jalen McDaniels,CHA,47,904,133,284,35,105,45,64,45,124,169,53,28,19,45,151,70,-19,67.69911504424779
203516,268,James Ennis III,ORL,41,986,115,243,45,104,70,87,43,123,166,62,32,7,36,128,59,-17,69.62474645030426
1629631,269,De'Andre Hunter,ATL,23,678,120,248,31,95,73,85,17,93,110,44,19,12,29,128,64,-12,68.28908554572271
1629020,269,Jarred Vanderbilt,MIN,64,1139,143,236,1,5,57,102,118,250,368,76,64,46,53,93,4,-45,115.97892888498681
1630184,271,Kira Lewis Jr.,NOP,54,904,130,337,40,120,43,51,12,59,71,124,38,10,34,207,80,-8,55.088495575221245
1630166,272,Deni Avdija,WAS,54,1257,130,312,53,168,29,45,22,240,262,63,32,15,33,182,115,-16,60.10342084327765
203939,272,Dwight Powell,DAL,58,966,120,194,5,21,97,124,80,154,234,63,36,30,40,74,16,-27,95.54865424430642
1630170,274,Devin Vassell,SAS,62,1056,123,303,52,150,43,51,24,150,174,56,43,18,22,180,98,-8,59.46969696969697
203488,275,Mike Muscala,OKC,35,645,119,267,68,184,33,36,19,113,132,28,8,11,21,148,116,-3,62.48062015503876
201580,276,JaVale McGee,DEN,46,678,144,282,5,24,44,67,77,162,239,39,19,54,60,138,19,-23,115.117994100295
1628539,276,Mychal Mulder,GSW,60,766,119,265,85,214,14,22,8,52,60,26,12,12,16,146,129,-8,37.66318537859008
202954,278,Brad Wanamaker,CHA,61,1053,115,299,16,85,90,101,18,87,105,174,43,11,71,184,69,-11,65.0997150997151
202687,279,Bismack Biyombo,CHA,66,1349,142,242,0,1,47,105,137,210,347,81,17,74,71,100,1,-58,88.99184581171238
200755,280,JJ Redick,DAL,44,723,106,267,66,178,49,52,4,60,64,51,11,3,36,161,112,-3,40.94052558782849
1626204,280,Larry Nance Jr.,CLE,35,1091,128,272,41,114,30,49,54,181,235,107,61,17,55,144,73,-19,86.84692942254813
203382,282,Aron Baynes,TOR,53,980,134,304,27,103,29,41,87,186,273,47,17,22,46,170,76,-12,72.14285714285714
203457,282,Nerlens Noel,NYK,64,1547,137,223,0,3,50,70,142,265,407,46,70,141,65,86,3,-20,97.89915966386555
203524,284,Solomon Hill,ATL,71,1514,107,298,68,212,35,46,42,172,214,75,50,11,42,191,144,-11,46.23513870541612
1629006,285,Josh Okogie,MIN,59,1197,102,254,29,108,83,108,63,93,156,63,54,28,43,152,79,-25,57.01754385964912
1627863,286,Danuel House Jr.,HOU,36,932,110,272,54,156,41,63,18,114,132,69,20,16,36,162,102,-22,55.15021459227468
1629234,287,Drew Eubanks,SAS,54,755,116,205,2,2,77,106,74,167,241,42,18,49,45,89,0,-29,113.50993377483442
1626163,288,Frank Kaminsky,PHX,47,715,121,257,31,85,37,60,36,152,188,79,14,17,22,136,54,-23,93.28671328671328
1629021,288,Moritz Wagner,ORL,45,722,104,229,31,91,71,87,27,119,146,50,26,18,43,125,60,-16,79.6398891966759
1628422,290,Damyean Dotson,CLE,46,907,119,293,46,159,24,36,5,88,93,91,16,4,42,174,113,-12,41.17971334068357
201567,291,Kevin Love,CLE,25,622,103,252,57,156,42,51,17,169,186,63,16,2,38,149,99,-9,92.84565916398714
1630173,292,Precious Achiuwa,MIA,61,737,124,228,0,1,56,110,73,135,208,29,20,28,43,104,1,-54,97.48982360922659
1629308,293,Juan Toscano-Anderson,GSW,53,1108,121,209,37,92,22,31,29,206,235,150,41,26,61,88,55,-9,93.63718411552347
1628396,294,Tony Bradley,OKC,42,684,131,197,0,3,38,55,85,154,239,37,15,30,33,66,3,-17,112.93859649122805
202397,295,Ish Smith,WAS,44,924,129,297,18,49,19,33,22,128,150,172,32,13,41,168,31,-14,83.06277056277057
1629684,296,Grant Williams,BOS,63,1138,108,247,48,129,30,51,48,130,178,64,32,24,56,139,81,-21,58.91915641476274
1627761,297,DeAndre' Bembry,TOR,51,972,117,228,14,53,45,66,33,113,146,107,53,18,71,111,39,-21,77.8292181069959
202355,297,Hassan Whiteside,SAC,36,546,126,224,0,1,41,79,61,154,215,20,9,46,40,98,1,-38,127.19780219780219
1629629,299,Cam Reddish,ATL,26,750,96,263,33,126,67,82,22,82,104,35,33,9,34,167,93,-15,48.733333333333334
203085,300,Austin Rivers,DEN,36,845,104,245,55,149,22,31,8,74,82,81,30,2,36,141,94,-9,51.83431952662721
1629635,300,Sekou Doumbouya,DET,56,869,107,282,26,115,45,64,39,104,143,47,24,9,44,175,89,-19,47.23820483314154
2772,302,Trevor Ariza,MIA,30,841,99,241,50,143,34,44,27,117,144,55,31,18,21,142,93,-10,64.03091557669441
1626161,303,Willie Cauley-Stein,DAL,53,906,115,182,1,11,49,78,66,170,236,35,21,43,29,67,10,-29,88.85209713024283
202083,304,Wesley Matthews,LAL,58,1130,89,252,66,197,35,41,20,73,93,54,38,17,26,163,131,-6,36.32743362831859
201976,305,Patrick Beverley,LAC,37,833,93,220,56,141,36,45,29,90,119,76,29,28,34,127,85,-9,70.16806722689076
1628021,306,David Nwaba,HOU,30,679,106,218,17,63,47,68,40,78,118,31,30,21,17,112,46,-21,69.80854197349042
2738,307,Andre Iguodala,MIA,63,1339,95,248,60,182,25,38,38,183,221,142,57,35,67,153,122,-13,70.50037341299478
203487,308,Michael Carter-Williams,ORL,31,800,105,270,15,61,49,80,39,100,139,129,25,17,69,165,46,-31,80.125
1628470,308,Torrey Craig,PHX,50,803,109,227,39,106,17,22,57,140,197,49,28,27,25,118,67,-5,82.12951432129513
203490,310,Otto Porter Jr.,ORL,28,607,98,227,39,104,36,42,28,124,152,55,16,4,25,129,65,-6,82.45469522240528
1630240,311,Saben Lee,DET,48,781,99,210,8,23,61,89,20,77,97,174,32,13,55,111,15,-28,95.07042253521126
1626169,311,Stanley Johnson,TOR,61,1006,89,233,45,137,44,55,29,124,153,89,52,18,54,144,92,-11,66.8986083499006
1626184,313,Chasson Randle,ORL,41,837,92,237,44,130,38,48,7,75,82,74,22,5,46,145,86,-10,46.117084826762245
1628997,314,Caleb Martin,CHA,53,818,96,256,31,125,41,64,31,110,141,67,37,12,33,160,94,-23,61.49144254278729
201188,315,Marc Gasol,LAL,52,993,88,194,50,122,36,50,38,177,215,109,26,58,53,106,72,-14,92.24572004028198
201588,316,George Hill,PHI,30,672,95,197,31,80,40,50,16,45,61,73,23,5,31,102,49,-10,60.9375
1628400,317,Semi Ojeleye,BOS,56,950,89,221,58,158,24,32,31,116,147,37,17,0,21,132,100,-8,45.473684210526315
203476,318,Gorgui Dieng,SAS,38,553,85,163,30,70,58,67,40,100,140,48,26,16,32,78,40,-9,106.69077757685352
1629162,319,Jordan McLaughlin,MIN,51,938,100,242,33,92,23,30,21,87,108,193,51,6,51,142,59,-7,81.60980810234541
1629011,319,Mitchell Robinson,NYK,31,853,115,176,0,0,26,53,113,139,252,17,35,45,26,61,0,-27,98.4759671746776
1629680,321,Matisse Thybulle,PHI,65,1298,102,243,43,143,8,18,30,94,124,63,105,71,32,141,100,-10,60.78582434514638
1630167,322,Obi Toppin,NYK,62,683,104,209,26,85,19,26,26,112,138,29,17,15,23,105,59,-7,62.88433382137628
1626172,323,Kevon Looney,GSW,61,1161,108,197,4,17,31,48,117,205,322,119,21,22,37,89,13,-17,90.31007751937985
203503,324,Tony Snell,ATL,47,992,88,171,62,109,11,11,18,94,112,59,13,11,21,83,47,0,53.881048387096776
1628975,325,Jevon Carter,PHX,60,717,94,223,56,151,4,7,16,76,92,71,29,9,16,129,95,-3,59.7629009762901
1630230,326,Naji Marshall,NOP,32,700,82,209,29,83,53,75,15,133,148,88,26,10,38,127,54,-22,86.57142857142858
203918,326,Rodney Hood,TOR,55,943,94,260,34,113,24,28,23,80,103,53,24,7,36,166,79,-4,35.79003181336161
1628382,328,Justin Jackson,MIL,34,577,89,221,36,117,31,37,16,61,77,52,15,2,32,132,81,-6,49.82668977469671
1629216,329,Gabe Vincent,MIA,50,655,88,233,46,149,20,23,10,46,56,67,21,2,34,145,103,-3,40.0763358778626
202357,329,Nemanja Bjelica,MIA,37,595,89,196,27,85,37,51,29,98,127,69,15,5,33,107,58,-14,79.66386554621849
200765,329,Rajon Rondo,LAC,45,769,95,215,36,89,16,17,18,92,110,199,37,4,79,120,53,-1,98.50455136540963
201959,332,Taj Gibson,NYK,45,936,99,158,3,15,40,55,99,151,250,36,31,49,22,59,12,-15,90.7051282051282
1628392,333,Isaiah Hartenstein,CLE,46,559,94,171,2,6,46,71,65,116,181,55,19,39,44,77,4,-25,124.32915921288014
1629622,333,Max Strus,MIA,39,507,85,187,50,148,16,24,5,36,41,24,11,2,8,102,98,-8,34.9112426035503
1629048,335,Goga Bitadze,IND,45,561,83,194,20,79,45,61,60,90,150,37,9,60,17,111,59,-16,93.67201426024955
1627774,335,Jake Layman,MIN,45,627,91,184,23,78,26,37,13,54,67,28,29,19,26,93,55,-11,53.66826156299841
1629052,337,Oshae Brissett,IND,21,519,73,151,33,78,50,65,29,86,115,18,19,20,10,78,45,-15,87.57225433526011
1629164,338,Brandon Goodwin,ATL,47,620,84,223,32,103,28,43,8,61,69,95,17,0,36,139,71,-15,57.49999999999999
1630168,338,Onyeka Okongwu,ATL,50,601,96,149,0,3,36,57,62,101,163,18,23,33,29,53,3,-21,98.58569051580699
1629002,340,Chimezie Metu,SAC,36,488,91,179,13,37,31,43,31,81,112,28,14,18,29,88,24,-12,83.40163934426229
1629717,341,Armoni Brooks,HOU,20,520,78,192,60,157,7,12,10,58,68,30,12,5,22,114,97,-5,48.55769230769231
1629642,342,Nassir Little,POR,48,640,78,167,28,80,36,45,32,96,128,23,5,13,18,89,52,-9,59.84374999999999
1630174,343,Aaron Nesmith,BOS,46,669,78,178,40,108,22,28,28,99,127,23,15,9,23,100,68,-6,57.847533632286996
1629139,343,Yuta Watanabe,TOR,50,723,79,180,36,90,24,29,36,123,159,40,26,19,19,101,54,-5,75.79529737206086
203118,345,Mike Scott,PHI,51,852,76,211,53,155,8,12,11,109,120,40,24,14,19,135,102,-4,44.48356807511737
1629651,346,Nicolas Claxton,BKN,32,594,90,145,1,5,31,64,43,123,166,28,23,40,18,55,4,-33,106.56565656565658
204020,347,Tyler Johnson,BKN,39,684,72,183,48,132,18,21,6,71,77,47,14,0,17,111,84,-3,42.39766081871345
1628998,348,Cody Martin,CHA,52,849,83,188,16,58,25,43,52,109,161,86,37,12,40,105,42,-18,74.79387514723203
202335,349,Patrick Patterson,LAC,38,582,72,165,40,112,13,17,19,56,75,29,14,8,11,93,72,-4,47.07903780068728
203090,350,Maurice Harkless,SAC,37,772,69,165,23,84,33,43,13,76,89,44,30,20,22,96,61,-10,50.45336787564767
200782,351,P.J. Tucker,MIL,52,1356,66,177,40,119,21,28,51,153,204,61,39,20,40,111,79,-7,49.52064896755162
204038,352,Langston Galloway,PHX,40,438,66,147,36,85,22,23,7,35,42,26,8,0,13,81,49,-1,46.23287671232877
1629723,353,John Konchar,MEM,43,575,69,138,21,56,25,30,35,93,128,47,30,9,18,69,35,-5,86.69565217391305
1628391,354,D.J. Wilson,HOU,35,433,68,168,30,87,17,25,20,92,112,23,11,16,22,100,57,-8,76.78983833718245
1627745,354,Damian Jones,SAC,39,546,70,103,1,5,42,58,36,85,121,29,11,29,26,33,4,-16,88.46153846153845
1629633,356,Jarrett Culver,MIN,34,499,69,168,13,53,29,48,34,70,104,24,17,9,28,99,40,-19,64.52905811623246
1626159,357,Justise Winslow,MEM,26,507,74,210,10,54,20,35,18,100,118,50,15,12,37,136,44,-15,67.45562130177515
1630165,358,Killian Hayes,DET,26,670,71,201,20,72,14,17,6,63,69,138,27,10,83,130,52,-3,67.91044776119402
202340,359,Avery Bradley,HOU,27,602,64,171,33,101,12,15,8,49,57,46,21,3,28,107,68,-3,40.53156146179402
1629670,360,Jordan Nwora,MIL,30,274,62,135,28,62,19,25,9,51,60,7,17,8,24,73,34,-6,90.51094890510949
1630222,361,Mason Jones,PHI,32,334,52,123,24,66,40,64,7,48,55,42,7,1,29,71,42,-24,81.1377245508982
203648,362,Thanasis Antetokounmpo,MIL,57,551,67,137,7,29,25,49,54,70,124,46,22,10,43,70,22,-24,83.48457350272233
1630205,363,Lamar Stevens,CLE,40,499,62,136,4,25,37,51,24,72,96,25,17,13,23,74,21,-14,67.83567134268537
1628995,364,Kevin Knox II,NYK,42,464,56,143,35,89,16,20,10,51,61,19,12,6,17,87,54,-4,47.62931034482759
1629685,365,Dylan Windler,CLE,31,513,57,130,26,77,21,27,20,87,107,33,19,12,32,73,51,-6,72.80701754385966
1628972,365,Troy Brown Jr.,CHI,34,523,62,144,22,70,15,21,20,85,105,29,10,6,21,82,48,-6,58.31739961759082
1627846,367,Abdel Nader,PHX,24,355,57,116,18,43,28,37,7,55,62,19,10,9,19,59,25,-9,73.66197183098592
1628991,368,Jaren Jackson Jr.,MEM,11,258,53,125,17,60,35,42,17,45,62,12,12,18,15,72,43,-7,88.95348837209302
1629103,369,Kelan Martin,IND,35,323,62,138,24,60,9,10,18,60,78,17,10,10,16,76,36,-1,78.63777089783281
1626246,370,Boban Marjanovic,DAL,33,271,62,122,1,8,31,38,47,81,128,10,2,6,12,60,7,-7,120.47970479704797
1629076,370,Tyler Cook,DET,32,437,69,103,1,2,17,35,28,67,95,17,8,2,21,34,1,-18,74.02745995423341
1628372,372,Dennis Smith Jr.,DET,23,420,58,145,19,58,19,26,12,43,55,77,23,14,26,87,39,-7,84.88095238095238
1630198,373,Isaiah Joe,PHI,41,383,48,133,39,106,18,24,6,30,36,20,12,4,11,85,67,-6,41.64490861618799
1629750,374,Javonte Green,CHI,41,474,53,102,10,30,30,40,26,45,71,17,28,6,19,49,20,-10,66.66666666666666
1626143,375,Jahlil Okafor,DET,27,347,63,102,2,9,17,24,23,43,66,13,6,5,21,39,7,-7,66.13832853025937
1628418,376,Thomas Bryant,WAS,10,271,59,91,9,21,16,24,18,43,61,15,4,8,11,32,12,-8,88.56088560885608
1629599,377,Amir Coffey,LAC,44,395,45,103,23,56,27,38,10,34,44,22,10,0,15,58,33,-11,52.278481012658226
1629713,378,Justin James,SAC,36,310,52,111,14,38,21,36,9,21,30,22,8,3,15,59,24,-15,54.516129032258064
1629744,378,Matt Thomas,UTA,45,327,50,127,27,80,12,14,7,37,44,19,4,0,14,77,53,-2,38.68501529051988
1627853,380,Ryan Arcidiacono,CHI,44,450,49,117,25,67,13,20,5,62,67,56,9,0,10,68,42,-7,63.55555555555556
1630192,380,Zeke Nnaji,DEN,42,397,50,104,24,59,12,15,14,51,65,10,8,4,7,54,35,-3,53.5264483627204
203960,382,JaKarr Sampson,IND,29,316,56,113,3,15,19,29,27,50,77,4,2,14,15,57,12,-10,68.0379746835443
1629740,382,Nicolo Melli,DAL,45,566,46,141,23,85,19,25,29,93,122,44,14,3,12,95,62,-6,58.657243816254415
1630237,384,Anthony Lamb,HOU,24,415,46,118,23,71,18,21,27,43,70,23,6,5,19,72,48,-3,49.63855421686747
202734,384,E'Twaun Moore,PHX,27,389,55,121,11,35,12,14,14,31,45,40,15,5,23,66,24,-2,57.84061696658098
1629610,386,DaQuan Jeffries,SAS,31,493,50,120,20,67,7,8,19,52,71,22,15,10,14,70,47,-1,46.34888438133874
1630271,387,Brodric Thomas,CLE,32,399,39,108,16,59,31,46,8,45,53,30,15,10,22,69,43,-15,57.769423558897245
1630233,388,Nathan Knight,ATL,33,279,37,100,6,33,44,55,27,45,72,8,9,10,15,63,27,-11,76.52329749103941
1630219,388,Skylar Mays,ATL,33,269,44,98,14,40,22,25,10,25,35,30,14,2,9,54,26,-3,72.11895910780669
1629035,390,Carsen Edwards,BOS,31,276,47,111,18,63,11,13,3,23,26,14,7,1,7,64,45,-2,30.978260869565215
1630185,390,Nico Mannion,GSW,30,364,39,114,22,60,23,28,6,40,46,70,16,1,31,75,38,-5,77.74725274725274
1628035,392,Alfonzo McKinnie,LAL,39,258,48,93,16,39,10,18,22,32,54,6,7,0,5,45,23,-8,68.02325581395348
1629677,392,Luka Samanic,SAS,33,308,47,105,12,43,16,29,16,52,68,15,8,8,20,58,31,-13,69.31818181818183
203922,394,Glenn Robinson III,SAC,23,369,42,99,16,44,21,23,11,34,45,20,4,3,11,57,28,-2,43.90243902439025
1629109,395,Gary Clark,PHI,39,654,40,132,31,108,8,10,33,82,115,31,13,7,17,92,77,-2,42.88990825688073
1629658,396,Jaylen Hoard,OKC,19,320,44,88,0,11,28,41,21,44,65,24,13,5,17,44,11,-13,78.59375
1626168,397,Trey Lyles,SAS,23,358,43,90,14,40,15,23,9,77,86,14,6,1,6,47,26,-8,67.59776536312849
203473,398,Dewayne Dedmon,MIA,16,210,46,65,1,5,20,27,28,58,86,12,9,6,13,19,4,-7,136.1904761904762
1630273,399,Freddie Gillespie,TOR,20,392,44,84,0,0,23,33,42,55,97,9,13,20,12,40,0,-10,83.6734693877551
1628778,399,Paul Watson,TOR,27,297,38,82,30,64,5,8,4,41,45,17,6,3,9,44,34,-3,63.63636363636363
1628385,401,Harry Giles III,POR,38,348,42,97,8,23,16,27,31,102,133,29,8,13,20,55,15,-11,111.92528735632183
1628990,402,Chandler Hutchison,WAS,25,346,39,103,8,22,21,25,6,72,78,17,12,5,20,64,14,-4,69.07514450867052
1628436,403,Luke Kornet,BOS,31,347,44,101,15,59,3,6,14,53,67,24,4,32,7,57,44,-3,66.28242074927954
1630210,404,Markus Howard,DEN,37,205,40,106,18,65,7,9,1,20,21,18,4,1,18,66,47,-2,28.536585365853657
1629671,404,Miye Oni,UTA,54,519,35,99,30,88,5,6,23,61,84,28,11,8,16,64,58,-1,48.747591522158
1628365,406,Markelle Fultz,ORL,8,215,41,104,4,16,17,19,5,20,25,43,8,2,18,63,12,-2,72.09302325581395
202329,407,Al-Farouq Aminu,CHI,23,434,38,99,8,37,18,22,22,88,110,31,19,9,28,61,29,-4,77.53456221198157
1630182,408,Josh Green,DAL,39,445,42,93,4,25,13,23,28,50,78,28,16,3,17,51,21,-10,58.539325842696634
1628455,409,Mike James,BKN,13,236,34,92,11,31,21,27,3,29,32,54,6,1,20,58,20,-6,83.89830508474576
1629682,410,Tremont Waters,BOS,26,238,34,84,15,38,16,17,5,16,21,62,15,1,27,50,23,-1,94.32773109243698
1628411,410,Wes Iwundu,NOP,41,539,34,102,5,41,26,31,15,75,90,18,15,4,19,68,36,-5,42.11502782931355
1630223,412,Jalen Harris,TOR,13,172,36,72,17,36,7,9,3,15,18,17,8,0,14,36,19,-2,72.96511627906976
1629662,413,Mfiondu Kabengele,CLE,39,280,33,89,13,50,16,20,12,48,60,17,8,13,15,56,37,-4,65.89285714285714
1628993,414,Alize Johnson,BKN,18,189,40,68,1,6,13,13,27,63,90,14,5,5,9,28,5,0,134.12698412698413
1630200,414,Tre Jones,SAS,37,269,37,78,3,5,17,19,8,13,21,39,8,0,13,41,2,-2,61.33828996282528
1629644,416,KZ Okpala,MIA,37,447,36,96,12,50,8,15,21,47,68,19,10,11,15,60,38,-7,43.84787472035794
1629649,417,Ignas Brazdeikis,ORL,13,249,35,83,11,28,10,14,11,34,45,17,4,3,12,48,17,-4,60.44176706827309
203585,417,Rodney McGruder,DET,16,194,37,70,11,24,6,8,8,14,22,16,8,1,7,33,13,-2,65.72164948453609
1628373,419,Frank Ntilikina,NYK,33,322,29,79,23,48,8,18,6,25,31,19,18,4,11,50,25,-10,59.161490683229815
1630241,419,Sam Merrill,MIL,30,233,32,72,21,47,4,4,6,24,30,21,8,1,10,40,26,0,63.519313304721024
1629185,421,Chris Chiozza,BKN,22,232,31,88,13,42,13,17,3,21,24,65,7,6,16,57,29,-4,85.12931034482759
1630194,421,Paul Reed,PHI,26,177,42,78,0,6,4,8,30,31,61,12,10,13,12,36,6,-4,116.94915254237289
1630235,421,Trent Forrest,UTA,30,302,32,71,5,26,19,19,11,33,44,45,9,4,21,39,21,0,69.03973509933775
1629657,424,Kyle Guy,SAC,31,235,29,88,13,46,16,20,5,30,35,32,6,0,11,59,33,-4,55.95744680851064
1630221,425,Josh Hall,OKC,21,336,30,99,4,37,22,44,6,53,59,28,4,1,25,69,33,-22,46.279761904761905
1628427,426,Vlatko Cancar,DEN,41,281,33,72,9,33,10,13,11,39,50,14,11,2,14,39,24,-3,58.00711743772242
1630466,427,Gabriel Deck,OKC,10,212,32,67,2,15,18,22,16,24,40,24,8,0,6,35,13,-4,74.29245283018868
1629010,428,Jerome Robinson,WAS,17,305,28,95,11,42,16,20,4,34,38,25,12,6,19,67,31,-4,46.39344262295082
1629017,429,Khyri Thomas,HOU,5,153,32,66,9,27,9,9,7,11,18,25,9,6,6,34,18,0,86.27450980392157
1630264,430,Anthony Gill,WAS,26,218,30,60,7,24,13,16,16,35,51,11,10,4,8,30,17,-3,79.58715596330275
1628966,431,Keita Bates-Diop,SAS,30,245,30,67,5,17,14,21,9,40,49,12,11,5,7,37,12,-7,71.83673469387755
1629067,432,Isaac Bonga,WAS,40,432,30,81,13,47,5,8,18,48,66,23,11,9,22,51,34,-3,47.22222222222222
1629617,432,Reggie Perry,BKN,26,211,32,78,4,21,10,13,27,46,73,14,6,6,15,46,17,-3,89.81042654028435
1626188,434,Quinn Cook,CLE,23,157,29,68,11,26,7,8,2,15,17,18,4,1,7,39,15,-1,58.917197452229296
203121,435,Darius Miller,OKC,18,197,22,48,17,42,12,12,2,22,24,21,13,5,8,26,25,0,81.47208121827411
1629743,435,Donta Hall,ORL,13,179,25,35,0,0,23,34,24,38,62,11,5,10,8,10,0,-11,128.49162011173186
1627885,435,Shaquille Harrison,DEN,34,332,26,78,3,16,18,22,7,41,48,25,17,5,11,52,13,-4,57.98192771084337
203953,438,Jabari Parker,BOS,13,165,30,55,2,11,10,13,10,32,42,11,1,5,10,25,9,-3,78.48484848484848
1629117,438,Wenyen Gabriel,NOP,21,241,24,60,13,32,11,17,20,34,54,11,9,8,15,36,19,-6,78.21576763485477
1628383,440,Justin Patton,HOU,13,247,29,70,9,34,3,4,14,35,49,14,12,14,4,41,25,-1,69.4331983805668
1629626,441,Bol Bol,DEN,32,160,25,58,9,24,10,15,0,24,24,7,3,10,13,33,15,-5,64.0625
1629604,442,CJ Elleby,POR,30,192,25,66,7,34,11,15,11,21,32,10,6,3,5,41,27,-4,45.57291666666667
101141,443,Ersan Ilyasova,UTA,17,148,21,54,18,41,5,5,7,22,29,4,10,3,8,33,23,0,77.36486486486487
1629714,444,Jarrell Brantley,UTA,28,138,25,52,12,28,2,2,9,18,27,15,7,2,8,27,16,0,87.68115942028986
203933,445,T.J. Warren,IND,4,117,27,51,0,7,8,10,2,12,14,5,2,0,4,24,7,-2,39.743589743589745
1629681,446,Killian Tillie,MEM,18,182,19,57,10,33,9,11,6,18,24,8,5,8,2,38,23,-2,45.32967032967033
1629648,447,Jordan Bone,ORL,14,196,23,54,10,32,0,0,4,20,24,18,2,0,3,31,22,0,40.30612244897959
1629641,447,Romeo Langford,BOS,18,283,21,59,5,18,9,12,12,23,35,13,6,5,10,38,13,-3,40.45936395759717
1627812,447,Yogi Ferrell,LAC,10,137,20,57,9,28,7,9,5,14,19,22,7,3,3,37,19,-2,72.62773722627736
1630187,450,Daniel Oturu,LAC,30,161,22,52,1,5,9,12,21,27,48,10,4,7,9,30,4,-3,88.81987577639751
1630188,451,Jalen Smith,PHX,27,156,22,50,4,17,5,7,7,30,37,4,1,4,7,28,13,-2,55.44871794871795
1628981,452,Bruno Fernando,ATL,33,226,18,44,0,2,15,22,16,62,78,10,4,3,21,26,2,-7,90.7079646017699
1629751,453,Dakota Mathias,PHI,8,123,19,48,8,26,2,6,1,6,7,13,1,3,1,29,18,-4,34.146341463414636
202334,453,Ed Davis,MIN,23,299,19,44,0,0,10,12,46,69,115,21,13,13,7,25,0,-2,114.71571906354514
1629605,455,Tacko Fall,BOS,19,136,21,29,0,0,5,15,16,36,52,3,1,20,6,8,0,-10,133.08823529411765
1629683,456,Quinndary Weatherspoon,SAS,20,121,16,35,1,6,13,16,3,8,11,8,8,2,10,19,5,-3,61.57024793388429
1630176,456,Vernon Carey Jr.,CHA,19,115,18,36,1,7,9,11,6,21,27,2,1,5,5,18,6,-2,66.08695652173913
1629663,458,Louis King,SAC,6,85,17,34,4,11,6,6,5,13,18,9,7,3,4,17,7,0,104.11764705882354
1629603,458,Mamadi Diakite,MIL,14,141,16,40,1,8,11,14,8,26,34,8,6,5,3,24,7,-3,78.36879432624113
1628419,460,Cameron Oliver,HOU,4,87,19,33,4,13,1,4,5,16,21,5,2,4,3,14,9,-3,84.48275862068965
1629606,460,Robert Franks,ORL,7,101,13,28,5,15,12,13,6,8,14,5,3,3,2,15,10,-1,63.366336633663366
1630216,462,Cassius Winston,WAS,22,98,14,33,8,17,5,6,0,9,9,12,2,1,5,19,9,-1,62.755102040816325
1629686,462,Deividas Sirvydis,DET,20,133,14,40,10,28,3,6,0,29,29,5,2,0,5,26,18,-3,53.383458646616546
1630207,462,Nate Hinton,DAL,21,93,15,42,4,19,7,10,1,8,9,8,7,2,5,27,15,-3,50.0
1628414,462,Sindarius Thornwell,ORL,21,217,15,46,7,23,4,8,3,15,18,21,13,2,7,31,16,-4,50.69124423963134
1629718,466,Charlie Brown Jr.,OKC,9,152,13,43,5,21,9,10,3,14,17,9,4,2,6,30,16,-1,34.21052631578947
1630186,466,Jahmi'us Ramsey,SAC,13,94,15,38,5,19,5,5,2,8,10,6,4,1,3,23,14,0,39.361702127659576
1629719,468,Devontae Cacok,LAL,20,98,17,29,0,0,5,11,12,20,32,1,5,4,5,12,0,-6,107.14285714285714
1630253,468,Sean McDermott,MEM,18,158,13,33,5,22,8,8,6,13,19,4,2,3,4,20,17,0,30.69620253164557
1630199,470,Cassius Stanley,IND,24,93,13,43,3,13,7,9,8,12,20,1,1,2,1,30,10,-2,37.634408602150536
203521,470,Matthew Dellavedova,CLE,13,224,14,56,4,25,4,4,6,18,24,58,4,1,6,42,21,0,60.04464285714286
1630206,472,Jay Scrubb,LAC,4,84,14,36,2,9,5,5,2,12,14,1,4,0,7,22,7,0,41.07142857142857
1629752,472,Juwan Morgan,UTA,29,147,14,30,4,13,3,7,9,19,28,9,4,1,4,16,9,-4,62.244897959183675
1629962,474,Devin Cannady,ORL,8,74,11,28,6,16,6,7,0,5,5,1,5,1,2,17,10,-1,44.5945945945946
1629730,474,Rayjon Tucker,PHI,14,68,9,18,2,7,14,19,1,10,11,6,2,0,4,9,5,-5,84.55882352941177
1629735,476,Chris Silva,SAC,15,92,10,16,1,1,11,15,7,20,27,6,1,6,10,6,0,-4,111.95652173913044
1630190,477,Elijah Hughes,UTA,18,64,10,30,8,23,3,4,1,8,9,6,1,1,6,20,15,-1,47.65625
1629066,477,Rodions Kurucs,MIL,21,125,11,32,6,21,3,4,5,18,23,10,9,4,13,21,15,-1,72.39999999999999
1627748,479,Thon Maker,CLE,8,76,10,18,0,2,10,11,8,10,18,4,2,4,3,8,2,-1,89.47368421052632
1629346,480,Alen Smailagic,GSW,15,84,11,27,4,10,2,6,6,10,16,4,3,5,5,16,6,-4,75.0
1626178,481,Rondae Hollis-Jefferson,POR,11,107,9,18,0,1,9,16,11,15,26,13,2,4,2,9,1,-7,99.53271028037383
1628412,482,Frank Mason,ORL,4,79,9,24,2,5,5,7,3,9,12,12,0,0,5,15,3,-2,63.92405063291139
1627780,482,Gary Payton II,GSW,10,40,10,13,2,4,3,4,2,9,11,1,6,1,1,3,2,-1,145.0
1626245,484,Cristiano Felicio,CHI,18,84,7,13,0,2,9,16,10,16,26,9,4,0,4,6,2,-7,114.28571428571428
203957,484,Dante Exum,HOU,6,116,10,26,2,11,1,2,2,15,17,13,4,2,7,16,9,-1,55.603448275862064
1629653,484,Devon Dotson,CHI,11,50,11,21,1,7,0,0,2,3,5,7,4,0,0,10,6,0,62.0
202738,484,Isaiah Thomas,NOP,3,48,9,27,3,12,2,2,1,3,4,5,1,0,6,18,9,0,19.791666666666664
1629725,488,Jeremiah Martin,CLE,9,75,9,33,3,12,1,5,2,5,7,4,5,2,6,24,9,-4,35.333333333333336
1629007,488,Jontay Porter,MEM,11,54,8,15,3,8,3,5,4,10,14,1,3,1,7,7,5,-2,89.81481481481481
1629620,490,Justin Robinson,OKC,9,88,7,21,4,14,3,5,1,6,7,9,3,0,2,14,10,-2,40.909090909090914
203658,491,Norvel Pelle,NYK,13,83,8,15,0,0,4,6,6,13,19,2,1,9,3,7,0,-2,84.33734939759037
1630218,491,Robert Woodard II,SAC,13,45,8,20,1,6,3,8,4,12,16,2,0,3,1,12,5,-5,92.22222222222223
203915,491,Spencer Dinwiddie,BKN,3,64,6,16,2,7,6,6,0,13,13,9,2,1,5,10,5,0,82.03125
1630203,494,Grant Riller,CHA,7,27,8,12,2,4,0,0,0,1,1,3,1,0,1,4,2,0,66.66666666666666
1630189,494,Tyler Bey,DAL,18,71,7,22,1,4,3,5,8,11,19,3,0,1,3,15,3,-2,58.45070422535211
201229,496,Anthony Tolliver,PHI,11,99,4,17,4,14,5,6,3,7,10,2,3,2,3,13,10,-1,31.313131313131315
203998,496,Bruno Caboclo,HOU,6,36,8,17,0,5,1,2,3,11,14,1,0,2,4,9,5,-1,76.38888888888889
1629091,498,Elijah Bryant,MIL,1,32,6,13,1,5,3,3,2,4,6,3,0,1,4,7,4,0,59.375
1628962,498,Udoka Azubuike,UTA,15,57,4,9,0,0,8,10,4,9,13,0,1,4,3,5,0,-2,80.7017543859649
1629690,500,Adam Mokoka,CHI,14,56,7,19,1,10,0,1,1,4,5,5,2,1,5,12,9,-1,24.107142857142858
1629244,500,Cameron Reynolds,HOU,5,40,6,18,3,12,0,0,2,3,5,2,0,0,0,12,9,0,8.75
1627740,500,Henry Ellenson,TOR,2,38,5,14,2,9,3,4,3,9,12,5,0,0,0,9,7,-1,77.63157894736842
203263,500,James Nunnally,NOP,9,48,5,13,4,12,1,2,2,7,9,3,0,0,2,8,8,-1,47.91666666666667
1628395,500,Jordan Bell,GSW,6,82,7,22,0,2,1,2,7,17,24,7,3,5,4,15,2,-1,87.8048780487805
1630208,500,Nick Richards,CHA,18,63,4,9,0,1,7,11,4,7,11,2,0,0,3,5,1,-4,54.761904761904766
1626253,506,Axel Toupane,MIL,8,61,4,11,1,2,5,7,0,6,6,4,2,3,0,7,1,-2,61.47540983606557
1628578,507,Amida Brimah,IND,5,29,5,8,0,0,3,3,2,6,8,1,0,5,4,3,0,0,113.79310344827587
2760,507,Anderson Varejao,CLE,5,36,4,16,0,1,5,9,7,13,20,3,0,2,1,12,1,-4,137.5
1627737,507,Marquese Chriss,GSW,2,27,5,14,1,5,2,4,3,10,13,2,0,2,2,9,4,-2,114.81481481481481
1629833,510,Keljin Blevins,POR,17,75,5,20,2,8,0,0,3,7,10,4,2,0,5,15,6,0,28.000000000000004
1628961,510,Kostas Antetokounmpo,LAL,15,56,3,10,0,0,6,13,4,15,19,1,2,4,11,7,0,-7,112.5
1628388,510,T.J. Leaf,POR,7,35,5,10,0,0,2,2,0,5,5,1,2,1,2,5,0,0,62.857142857142854
1630211,513,Karim Mane,ORL,10,88,3,13,1,2,4,5,1,13,14,4,0,2,3,10,1,-1,44.88636363636363
1630179,513,Tyrell Terry,DAL,11,56,5,16,0,7,1,3,0,6,6,6,5,0,2,11,7,-2,45.535714285714285
203086,515,Meyers Leonard,MIA,3,29,3,7,3,7,1,2,0,7,7,2,0,0,2,4,4,-1,75.86206896551724
1630268,516,Nate Darling,CHA,7,26,2,7,2,7,3,3,1,0,1,1,0,1,1,5,5,0,17.307692307692307
1630234,516,Ty-Shon Alexander,PHX,15,47,3,12,2,9,1,2,2,8,10,6,0,1,3,9,7,-1,54.25531914893617
1629712,518,Didi Louzada,NOP,3,56,3,13,2,8,0,0,1,2,3,3,2,0,3,10,6,0,14.285714285714285
204025,518,Tim Frazier,MEM,5,62,3,20,0,8,2,6,0,8,8,16,2,1,4,17,8,-4,58.06451612903226
1629738,518,Vincent Poirier,PHI,10,39,3,12,0,1,2,6,6,8,14,2,0,3,4,9,1,-4,93.58974358974359
1629716,521,Marques Bolden,CLE,6,29,1,3,0,0,5,8,3,3,6,0,2,2,2,2,0,-3,100.0
203460,522,Andre Roberson,BKN,5,63,2,14,1,8,1,2,7,8,15,4,3,1,2,12,7,-1,53.17460317460318
201162,522,Jared Dudley,LAL,12,81,2,9,2,6,0,0,4,17,21,5,1,1,2,7,4,0,64.19753086419753
1629665,524,Jalen Lecque,IND,4,12,1,9,0,1,3,3,2,3,5,2,0,0,0,8,1,0,70.83333333333334
1627739,524,Kris Dunn,ATL,4,45,1,12,0,2,3,4,0,6,6,2,2,2,3,11,2,-1,37.77777777777778
1627775,524,Patrick McCaw,TOR,5,33,1,1,0,0,3,3,1,2,3,4,2,0,0,0,0,0,72.72727272727273
1629034,527,Ray Spalding,HOU,2,19,2,4,0,1,0,2,2,2,4,0,0,2,3,2,1,-2,65.78947368421053
2617,527,Udonis Haslem,MIA,1,3,2,2,0,0,0,0,0,1,1,0,0,0,0,0,0,0,133.33333333333331
1628968,529,Brian Bowen II,IND,6,15,1,4,0,1,1,1,0,3,3,0,0,0,0,3,1,0,23.333333333333332
1629607,529,Jared Harper,NYK,8,16,0,4,0,1,3,4,0,2,2,1,0,0,3,4,1,-1,28.125
1630238,529,Malik Fitts,LAC,3,11,1,3,1,2,0,0,0,3,3,0,0,0,0,2,1,0,59.09090909090909
202697,532,Iman Shumpert,BKN,2,11,1,4,0,3,0,0,1,0,1,0,1,0,1,3,3,0,-13.636363636363635
1629121,532,Jaylen Adams,MIL,7,18,1,8,0,2,0,0,0,3,3,2,0,0,0,7,2,0,5.555555555555555
1628390,532,Terrance Ferguson,PHI,13,49,1,7,0,5,0,0,0,1,1,2,1,0,4,6,5,0,-7.142857142857142
1629033,532,Theo Pinson,NYK,17,34,1,9,0,8,0,0,0,5,5,1,0,0,1,8,8,0,-20.588235294117645
1628394,536,Anzejs Pasecniks,WAS,1,6,0,1,0,1,0,0,1,0,1,1,0,0,5,1,1,0,25.0
1630204,536,Ashton Hagans,MIN,2,4,0,0,0,0,0,0,0,0,0,0,0,0,1,0,0,0,0.0
204222,536,Greg Whittington,DEN,4,12,0,3,0,2,0,0,0,0,0,0,0,0,0,3,2,0,-50.0
203943,536,Noah Vonleh,BKN,4,11,0,3,0,2,0,0,0,1,1,1,0,0,2,3,2,0,-18.181818181818183
1630266,536,Will Magnay,NOP,1,3,0,1,0,1,0,0,0,0,0,0,0,0,1,1,1,0,-83.33333333333334
